light_id	5a9fc479ab70786ba5a1eaaa	string	Filter launches by mongo document id
start/end	start=2017-06-22&end=2017-06-25	valid JavaScript date format	Include both to sort by date range
flight_number	60	integer	Filter by flight number
launch_year	2018	integer	Filter by launch year
launch_date_utc	2017-06-23T19:10:000Z	UTC ISO timestamp	Filter by utc launch date
launch_date_local	2017-06-23T19:10:000Z	Local ISO timestamp	Filter by local launch date
rocket_id	falconheavy	string	Filter by rocket ID
rocket_name	Falcon+Heavy	string	Filter by rocket name
rocket_type	FT	string	Filter by rocket type
core_serial	B1045	string	Filter by core serial number
land_success	true	boolean	Filter by successful core landings
landing_intent	true	boolean	Filter by landing intention
landing_type	ASDS	string	Filter by landing method
landing_vehicle	OCISLY	string	Filter by landing vehicle
cap_serial	C111	string	Filter by capsule serial number
core_flight	2	integer	Filter by number of previous core flights
block	5	integer	Filter by core block number
core_reuse	true	boolean	Filter launches by reused cores
capsule_reuse	true	boolean	Filter launches by reused capsules
fairings_reused	true	boolean	Filter by reused fairings
fairings_recovery_attempt	false	boolean	Filter by fairing recovery attempts
fairings_recovered	false	boolean	Filter by recovered fairings
fairings_ship	MRSTEVEN	string	Filter by fairings ship used
site_id	ksc_lc_39a	string	Filter by launch site ID
site_name	KSC LC 39A	string	Filter by launch site ID
payload_id	BulgariaSat-1	string	Filter by payload ID
norad_id	43571	integer	Filter by NORAD ID
customer	Iridium	string	Filter by launch payload customer
nationality	Bulgaria	string	Filter by payload nationality
manufacturer	SSL	string	Filter by payload manufacturer
payload_type	Satellite	string	Filter by payload type
orbit	GTO	string	Filter by payload orbit
reference_system	geocentric	string	Filter by payload orbit reference system
regime	geostationary	string	Filter by payload orbit regime
longitude	-108	float	Filter by payload orbit longitude
semi_major_axis_km	21226.178	float	Filter by payload orbit semi major axis
eccentricity	0.6904141	float	Filter by payload orbit eccentricity
periapsis_km	193.19	float	Filter by payload orbit periapsis
apoapsis_km	29502.896	float	Filter by payload orbit apoapsis
inclination_deg	27.0648	float	Filter by payload orbit inclination
period_min	512.941	float	Filter by payload orbit period
lifespan_years	512.941	integer	Filter by payload lifespan in years
epoch	2018-08-07T06:57:16.000Z	string	Filter by payload orbit epoch
mean_motion	2.80734018	float	Filter by payload orbit mean motion
raan	227.0228	float	Filter by payload orbit right ascension of the ascending node
launch_success	true	boolean	Filter by launch success
id	true	boolean	Set as true to show mongo document id's
limit	3	integer	Limit results returned, defaults to all documents returned
offset	3	integer	Offset or skip results from the beginning of the query
sort	flight_number	string	Change result sorting by setting value to any parameter in this list
order	desc	string	Change result ordering by setting values of asc or desc
